30 30
100 100
37 2 3 4 5 37 37 29 29 41 33 33 29 33 29 33 33 29 29 33 29 29 33 33 33 29 29 29 33 29
29 6 7 8 9 33 10 11 12 13 14 15 14 15 10 12 13 13 15 10 12 13 14 15 13 10 12 13 77 33
37 77 15 14 77 29 13 13 15 10 12 13 14 15 13 10 12 13 14 14 12 13 14 15 14 21 10 12 13 33
41 18 14 14 15 41 13 14 15 14 15 10 12 33 33 33 29 33 29 33 13 14 15 13 10 18 13 14 77 33
41 19 20 14 12 33 81 12 13 14 15 77 33 36 13 15 10 12 13 14 37 14 15 13 23 23 10 12 13 29
37 12 14 21 15 33 13 15 10 12 13 14 29 13 10 12 13 15 14 12 18 41 15 10 12 13 23 12 13 29
29 14 15 19 15 41 14 15 14 12 13 13 41 10 12 13 14 13 14 21 20 13 29 12 13 22 14 12 77 29
33 12 14 15 15 37 14 12 33 13 37 10 37 13 14 13 14 15 13 12 13 13 37 10 12 13 19 13 13 29
41 14 15 12 15 41 81 10 12 13 14 77 41 10 12 13 15 14 15 10 12 13 41 15 13 10 12 13 15 33
29 14 14 18 14 29 10 37 12 37 14 12 33 14 15 14 14 15 10 12 13 13 15 10 12 13 14 13 13 33
33 14 23 12 14 33 14 15 13 10 12 41 15 14 12 41 13 12 13 14 15 13 10 12 13 15 14 21 77 33
33 12 20 19 14 33 12 13 14 13 14 15 37 12 13 13 37 13 14 14 12 13 14 15 12 13 18 13 14 29
41 14 21 22 15 41 81 13 13 15 10 12 29 14 13 14 15 41 13 10 12 13 15 14 15 10 12 13 35 29
37 12 14 15 15 29 15 10 12 13 14 13 33 15 13 10 12 15 37 33 29 41 37 29 33 33 29 41 77 33
29 14 15 12 14 37 15 14 12 13 13 15 10 29 13 13 15 14 12 13 13 15 10 12 13 15 13 10 12 29
29 10 12 13 14 41 13 14 13 14 15 15 13 10 37 13 15 10 12 13 14 13 14 15 15 13 10 12 12 33
29 14 12 13 18 29 13 13 15 10 12 13 14 13 41 29 13 13 15 10 12 13 14 13 14 12 13 13 15 29
29 10 10 20 10 29 14 15 12 14 15 15 11 12 41 14 33 12 11 10 18 19 20 21 18 15 10 21 23 33
37 14 15 12 23 37 33 33 29 12 13 13 15 10 37 13 14 29 37 41 15 13 10 12 13 23 20 12 13 33
37 12 14 15 22 41 12 13 13 15 10 12 13 14 29 14 20 13 12 13 41 41 29 12 13 22 13 13 13 33
41 14 15 12 77 29 10 12 13 14 15 13 10 12 33 15 37 15 10 12 13 14 15 33 10 12 13 15 14 33
29 12 14 15 41 10 12 13 14 14 12 13 14 15 33 14 29 10 12 23 23 15 10 12 29 14 13 13 13 29
29 14 15 29 15 14 15 13 10 12 13 15 14 12 33 13 33 13 14 15 21 10 12 13 15 33 15 20 10 29
41 12 37 15 13 12 13 14 13 14 15 13 12 13 29 12 13 29 14 12 22 14 15 12 13 14 37 14 15 29
41 14 37 41 41 29 33 33 29 37 37 41 14 13 41 15 15 13 37 12 19 15 14 15 10 12 13 41 15 29
33 12 14 15 10 15 10 81 37 81 13 14 15 13 37 12 15 10 12 19 14 18 14 15 13 10 12 14 15 33
33 14 15 12 33 15 14 37 19 13 15 18 12 13 29 15 14 12 13 13 18 10 12 13 15 13 10 12 13 33
29 10 12 29 12 13 37 18 14 15 15 13 19 12 33 77 20 12 13 14 13 10 11 12 13 19 10 23 22 33
37 77 37 13 12 13 20 15 10 12 13 14 13 37 77 33 82 15 82 12 82 14 82 14 82 23 82 15 15 33
37 41 37 33 33 33 29 29 29 33 29 33 29 33 33 33 29 33 33 33 29 29 29 33 33 33 33 29 29 29
20
1 230 950 190 1
1 230 1010 190 2
1 230 1070 190 3
1 230 1150 190 4
1 230 1220 190 1
1 230 1595 190 4
2 300 1790 200 2
1 850 1550 100 1
2 850 1000 500 4
2 850 1050 500 3
2 850 950 500 5
1 800 70 1000 7
1 1000 110 1000 8
1 1300 600 300 2
1 1200 500 200 4
2 1300 400 500 12
2 1110 360 500 9
1 1714 1480 20 1
1 1714 1320 100 2
1 1714 1220 200 3
20
80 1500
80 1535
80 1570
450 1810
500 1810
400 1225
1600 200
1600 400
1600 600
1050 280
1100 280
900 280
950 280
1150 280
1200 280
1000 280
970 1320
970 1420
970 1520
970 1220
1790 1790






