30 30
800 150
16 17 16 17 16 17 16 17 16 17 16 2 3 4 5 17 16 17 16 17 16 17 16 17 16 17 16 17 16 17
17 82 27 82 30 82 32 82 31 82 16 6 7 8 9 16 78 31 78 30 78 32 78 31 78 26 78 28 78 16
16 32 30 31 32 30 31 32 31 32 17 78 32 30 30 30 16 27 28 30 26 27 28 30 31 32 30 31 78 17
17 30 31 32 30 31 32 26 27 28 16 26 27 28 30 16 32 30 31 32 30 31 32 26 27 28 30 31 32 16
16 26 27 28 30 31 32 30 31 32 17 78 32 26 27 30 31 32 26 27 28 30 26 27 28 30 31 32 78 17
17 31 32 30 31 32 31 32 30 31 16 26 27 28 30 31 32 30 31 32 30 31 32 26 27 28 30 31 32 16
16 30 31 32 30 31 32 26 27 28 17 78 27 28 30 31 32 30 31 32 30 31 32 30 31 32 30 31 78 17
17 27 28 30 31 32 30 31 32 30 16 32 26 27 30 31 32 30 31 32 31 32 30 31 32 30 31 32 26 16
16 26 27 28 30 31 32 30 31 32 17 78 32 26 27 28 30 31 32 17 16 17 16 17 16 31 30 26 78 17
17 32 30 31 32 31 32 30 31 32 16 31 32 26 27 28 30 26 16 28 30 31 32 30 31 32 27 28 30 16
16 26 27 28 30 31 32 30 31 32 17 78 32 26 27 28 30 17 32 30 31 32 30 31 32 26 27 28 78 17
17 26 27 28 30 31 32 30 31 32 16 17 16 17 16 17 16 31 32 30 31 32 30 31 32 26 27 28 30 16
16 32 30 31 32 17 31 32 31 32 16 78 32 30 31 32 26 27 28 30 26 27 28 30 31 32 30 31 78 17
17 30 31 32 30 16 32 26 27 28 17 26 27 28 30 31 32 30 31 32 30 31 32 26 27 28 30 31 32 16
16 26 27 28 30 17 78 30 31 32 16 31 32 26 27 30 31 32 26 27 28 30 26 27 28 30 31 32 30 17
17 82 32 30 31 16 31 32 30 31 17 26 27 28 30 31 32 30 31 32 30 31 32 26 27 28 30 31 32 16
16 30 31 32 30 17 78 26 27 28 16 26 27 28 30 31 32 30 31 32 30 31 32 30 31 32 30 31 32 17
17 78 28 30 31 16 30 31 32 30 17 32 26 27 30 31 32 30 31 32 82 32 82 31 82 30 82 32 82 16
16 26 27 28 30 17 78 30 31 32 16 31 32 26 27 28 30 31 32 30 16 17 16 17 16 17 16 17 16 17
17 82 30 31 16 78 31 32 30 31 32 17 31 32 26 27 28 30 26 27 16 30 31 32 30 31 32 28 30 16
16 26 27 28 16 31 32 30 31 32 16 31 32 26 27 28 30 31 17 30 31 32 30 31 32 26 27 28 30 17
17 78 27 28 16 78 32 30 31 32 17 31 32 17 27 28 30 16 32 30 31 32 30 31 32 26 27 28 30 16
16 30 31 32 16 31 32 26 27 28 30 26 27 16 30 31 32 30 31 32 30 31 32 30 31 32 30 31 32 17
17 82 28 30 17 78 30 31 32 30 31 32 26 17 30 31 32 30 31 32 31 32 30 31 32 30 31 32 26 16
16 26 27 28 16 31 32 30 31 32 30 31 32 16 27 28 30 31 32 30 31 32 31 32 30 31 30 26 27 17
17 78 30 31 17 78 32 30 31 32 30 31 32 17 27 28 30 26 27 28 30 31 32 30 31 32 27 28 30 16
16 26 27 28 16 31 32 30 31 32 30 31 32 16 27 28 30 31 32 30 31 32 30 31 32 26 27 28 30 17
17 26 27 28 17 78 32 30 31 32 30 31 32 17 27 28 30 31 32 30 31 32 30 31 32 26 27 28 30 16
17 26 27 28 16 31 78 30 78 32 78 31 32 16 27 28 30 31 32 30 31 32 30 31 32 26 27 28 30 17
16 17 16 17 16 17 16 17 16 17 16 17 16 17 16 17 16 17 16 17 16 17 16 17 16 17 16 17 16 17
15
3 900 250 500 4
3 800 300 500 5
3 1400 700 300 4
3 1700 800 200 2
3 1500 900 300 3
3 1100 1600 400 4
1 1200 1500 200 1
1 1300 1550 300 2
1 1400 1600 400 3
1 1500 1650 500 4
1 1600 1700 600 5
3 200 400 200 2
3 250 500 300 1
3 300 600 350 3
3 400 700 250 4
11
1500 400
1600 400
1700 400
65 1790
1500 1790
1550 1790
1600 1790
1650 1790
1700 1790
1750 1790
1800 1790
65 1790


