30 30
1700 200
47 48 58 47 48 42 47 48 42 47 48 58 47 48 42 47 48 58 47 48 42 47 48 42 47 2 3 4 5 58
43 80 46 80 52 80 54 80 52 80 52 80 52 80 53 80 52 80 46 80 53 80 52 80 47 6 7 8 8 47
47 53 70 52 53 51 52 52 53 54 52 54 46 51 70 53 54 51 52 53 52 46 70 53 49 76 52 46 76 44
42 75 52 53 70 46 52 53 54 52 70 46 51 53 52 44 53 51 54 52 53 54 52 53 50 52 52 46 52 47
47 46 51 52 53 54 51 52 53 52 46 52 52 46 58 52 42 54 51 52 53 52 51 53 56 76 53 51 76 43
44 75 52 53 52 52 52 51 54 53 54 51 52 44 52 53 54 42 53 52 54 52 46 52 57 68 52 46 51 47
47 53 54 51 54 53 52 46 52 54 53 52 43 52 53 54 54 54 43 52 46 51 53 52 49 76 51 52 76 42
44 75 46 51 53 52 52 53 51 52 52 53 54 43 53 52 52 44 46 52 53 53 52 46 50 53 54 52 52 47
48 51 53 52 52 53 53 52 52 52 51 52 53 54 58 52 59 52 46 52 54 53 70 52 52 46 51 52 76 44
43 75 53 51 70 52 53 54 52 53 52 52 53 52 46 42 54 53 52 54 52 46 54 53 54 52 52 46 51 47
47 52 53 54 52 53 42 43 44 44 43 58 52 53 54 52 53 52 52 44 59 42 43 58 59 43 44 43 42 59
43 75 52 53 52 59 52 54 53 52 52 52 44 51 52 53 54 51 58 53 52 46 52 54 42 70 52 52 54 47
48 53 54 52 52 44 52 53 53 52 70 52 46 43 53 70 52 43 51 52 52 53 54 52 43 52 52 52 46 42
59 75 52 53 54 44 52 53 54 46 52 54 53 52 42 52 59 52 53 54 52 53 51 52 44 54 46 51 52 47
47 54 51 52 53 43 46 52 54 53 52 52 54 53 52 44 52 51 52 53 54 51 52 53 44 46 52 54 53 44
43 75 46 51 52 43 54 51 52 53 52 46 52 54 53 52 52 52 46 52 53 52 52 53 43 52 52 53 76 47
47 53 52 52 53 44 52 52 53 54 52 52 46 51 52 53 54 51 52 53 52 46 52 53 42 52 52 46 51 44
42 75 52 53 52 58 52 53 54 52 52 46 51 53 52 70 53 51 52 52 53 54 52 53 43 54 52 46 80 47
47 46 51 52 53 54 51 52 53 52 46 52 52 46 51 52 53 54 51 52 53 52 51 53 44 52 53 51 52 43
44 75 52 53 52 42 52 51 52 53 54 51 52 53 52 46 52 54 53 54 52 52 46 52 44 52 52 46 76 47
47 53 54 51 52 53 52 46 52 54 53 52 52 52 46 52 53 54 52 52 46 51 53 52 58 53 51 52 52 42
44 75 46 51 53 43 52 53 51 52 52 53 54 52 53 52 52 52 46 52 53 53 52 46 43 53 54 52 80 47
48 51 53 52 52 53 53 52 54 52 51 52 53 54 51 52 53 52 46 52 54 53 52 52 52 46 51 54 53 44
59 75 53 51 70 44 53 54 52 53 52 52 53 52 47 52 54 53 52 52 52 46 52 53 54 52 52 46 76 47
47 52 53 54 52 53 53 52 52 53 51 52 52 56 54 56 53 52 54 52 46 52 53 53 70 52 51 52 53 43
43 75 52 53 52 44 52 54 53 52 52 52 56 51 52 53 57 51 52 53 52 46 52 54 53 52 52 52 80 47
44 52 46 51 53 52 52 53 51 52 70 57 54 52 53 52 54 56 46 52 53 53 52 46 52 53 54 52 52 42
48 75 53 52 52 59 53 52 52 52 56 52 53 54 51 52 53 52 56 52 54 53 52 52 52 46 51 52 76 47
43 52 53 51 70 52 53 54 52 56 52 52 53 52 46 52 54 53 52 57 52 76 52 80 54 76 52 80 51 42
47 48 42 47 48 58 47 48 42 47 48 42 47 48 58 47 48 42 47 48 42 47 48 42 47 48 58 47 48 42
13
2 1100 200 200 1
2 1200 400 200 1
2 1100 600 50 1
2 800 600 100 1
1 230 900 190 1
1 250 960 100 2
1 200 1020 150 3
1 200 1080 110 2
1 190 1160 200 4
3 900 1200 900 3
3 900 1325 900 3
3 900 1450 900 2
3 1000 1000 900 4
10
200 300
300 300
400 300
200 400
200 500
1700 1600
1700 1500
1700 1400
1700 1300
1700 1200
1790 710
